Left_Apical_Anterior_Fibromuscular_Stroma_of_Prostate	Left Apical Anterior Fibromuscular Stroma of Prostate	Fibromuscular_Stroma_of_Prostate
Left_Anterior_Apical_Peripheral_Zone_of_Prostate	Left Anterior Apical Peripheral Zone of Prostate	Peripheral_Zone_of_Prostate
Left_Posterolateral_Apical_Peripheral_Zone_of_Prostate	Left Posterolateral Apical Peripheral Zone of Prostate	Peripheral_Zone_of_Prostate
Left_Posteromedial_Apical_Peripheral_Zone_of_Prostate	Left Posteromedial Apical Peripheral Zone of Prostate	Peripheral_Zone_of_Prostate
Left_Anterior_Apical_Transition_Zone_of_Prostate	Left Anterior Apical Transition Zone of Prostate	Transition_Zone_of_Prostate
Left_Posterior_Apical_Transition_Zone_of_Prostate	Left Posterior Apical Transition Zone of Prostate	Transition_Zone_of_Prostate
Right_Apical_Anterior_Fibromuscular_Stroma_of_Prostate	Right Apical Anterior Fibromuscular Stroma of Prostate	Fibromuscular_Stroma_of_Prostate
Right_Anterior_Apical_Peripheral_Zone_of_Prostate	Right Anterior Apical Peripheral Zone of Prostate	Peripheral_Zone_of_Prostate
Right_Posterolateral_Apical_Peripheral_Zone_of_Prostate	Right Posterolateral Apical Peripheral Zone of Prostate	Peripheral_Zone_of_Prostate
Right_Posteromedial_Apical_Peripheral_Zone_of_Prostate	Right Posteromedial Apical Peripheral Zone of Prostate	Peripheral_Zone_of_Prostate
Right_Anterior_Apical_Transition_Zone_of_Prostate	Right Anterior Apical Transition Zone of Prostate	Transition_Zone_of_Prostate
Right_Posterior_Apical_Transition_Zone_of_Prostate	Right Posterior Apical Transition Zone of Prostate	Transition_Zone_of_Prostate
Left_Basal_Anterior_Fibromuscular_Stroma_of_Prostate	Left Basal Anterior Fibromuscular Stroma of Prostate	Fibromuscular_Stroma_of_Prostate
Central_Zone_of_Left_Half_Prostate	Central Zone of Left Half Prostate	Central_Zone_of_Prostate
Left_Anterior_Basal_Peripheral_Zone_of_Prostate	Left Anterior Basal Peripheral Zone of Prostate	Peripheral_Zone_of_Prostate
Left_Anterior_Basal_Transition_Zone_of_Prostate	Left Anterior Basal Transition Zone of Prostate	Transition_Zone_of_Prostate
Left_Posterior_Basal_Transition_Zone_of_Prostate	Left Posterior Basal Transition Zone of Prostate	Transition_Zone_of_Prostate
Left_Posterolateral_Basal_Peripheral_Zone_of_Prostate	Left Posterolateral Basal Peripheral Zone of Prostate	Peripheral_Zone_of_Prostate
Right_Basal_Anterior_Fibromuscular_Stroma_of_Prostate	Right Basal Anterior Fibromuscular Stroma of Prostate	Fibromuscular_Stroma_of_Prostate
Central_Zone_of_Right_Half_Prostate	Central Zone of Right Half Prostate	Central_Zone_of_Prostate
Right_Anterior_Basal_Peripheral_Zone_of_Prostate	Right Anterior Basal Peripheral Zone of Prostate	Peripheral_Zone_of_Prostate
Right_Posterolateral_Basal_Peripheral_Zone_of_Prostate	Right Posterolateral Basal Peripheral Zone of Prostate	Peripheral_Zone_of_Prostate
Right_Anterior_Basal_Transition_Zone_of_Prostate	Right Anterior Basal Transition Zone of Prostate	Transition_Zone_of_Prostate
Right_Posterior_Basal_Transition_Zone_of_Prostate	Right Posterior Basal Transition Zone of Prostate	Transition_Zone_of_Prostate
Left_Seminal_Vesicle	Left Seminal Vesicle	Seminal_Vesicle
Left_Middle_Anterior_Fibromuscular_Stroma_of_Prostate	Left Middle Anterior Fibromuscular Stroma of Prostate	Fibromuscular_Stroma_of_Prostate
Left_Anterior_Middle_Peripheral_Zone_of_Prostate	Left Anterior Middle Peripheral Zone of Prostate	Peripheral_Zone_of_Prostate
Left_Posterolateral_Middle_Peripheral_Zone_of_Prostate	Left Posterolateral Middle Peripheral Zone of Prostate	Peripheral_Zone_of_Prostate
Left_Posteromedial_Middle_Peripheral_Zone_of_Prostate	Left Posteromedial Middle Peripheral Zone of Prostate	Peripheral_Zone_of_Prostate
Left_Anterior_Middle_Transition_Zone_of_Prostate	Left Anterior Middle Transition Zone of Prostate	Transition_Zone_of_Prostate
Left_Posterior_Middle_Transition_Zone_of_Prostate	Left Posterior Middle Transition Zone of Prostate	Transition_Zone_of_Prostate
Right_Middle_Anterior_Fibromuscular_Stroma_of_Prostate	Right Middle Anterior Fibromuscular Stroma of Prostate	Fibromuscular_Stroma_of_Prostate
Right_Anterior_Middle_Peripheral_Zone_of_Prostate	Right Anterior Middle Peripheral Zone of Prostate	Peripheral_Zone_of_Prostate
Right_Posterolateral_Middle_Peripheral_Zone_of_Prostate	Right Posterolateral Middle Peripheral Zone of Prostate	Peripheral_Zone_of_Prostate
Right_Posteromedial_Middle_Peripheral_Zone_of_Prostate	Right Posteromedial Middle Peripheral Zone of Prostate	Peripheral_Zone_of_Prostate
Right_Anterior_Middle_Transition_Zone_of_Prostate	Right Anterior Middle Transition Zone of Prostate	Transition_Zone_of_Prostate
Right_Posterior_Middle_Transition_Zone_of_Prostate	Right Posterior Middle Transition Zone of Prostate	Transition_Zone_of_Prostate
Right_Seminal_Vesicle	Right Seminal Vesicle	Seminal_Vesicle
Male_External_Urethral_Sphincter	Male External Urethral Sphincter	Urethral_Sphincter
